F 251,237,188
C 122,216,250

NO ./textures/pink.xpm
SO ./textures/red.xpm
WE ./textures/green.xpm
EA ./textures/yellow.xpm

1111111111111111111
10W0001001001000001
1011000001000001001
1001001011111101111
1001111000001001001
1000000000001001001
1011111111111001001
1111000000000001011
1000000001000000001
1111111111111111111

