NO ./textures/pink.xpm
SO ./textures/red.xpm
WE ./textures/green.xpm
EA ./textures/yellow.xpm

F 251,237,188
C 122,216,250

111111111
100000001
1000W0001
100000001
111111111
