NO ./textures/pink.xpm
SO ./textures/red.xpm
WE ./textures/green.xpm
EA ./textures/yellow.xpm

F 251,237,188
C 122,216,250
1
111111011111111
111111000111111
111110000011111
1111000N0001111111111111111111111111111
111000000000111
110000000000011
100001111100001
110000111000011
111000010000111
111100000001111
111110000011111
111111000111111
111111111111111