NO ./textures/pink.xpm
SO ./textures/red.xpm
WE ./textures/green.xpm
EA ./textures/yellow.xpm

F 251,237,188
C 122,216,250

111111111111
1         11
1       0001
1000000 0011
10S000000001
11 111111111
11         1
111111111111
