NO ./textures/pink.xpm
SO ./textures/red.xpm
WE ./textures/green.xpm
EA ./textures/yellow.xpm

F 251,237,188
C 122,216,250

    11
   1001
  100000
 1000N001
1111111111