NO ./textures/pink.xpm

SO ./textures/red.xpm

WE ./textures/green.xpm

EA ./textures/yellow.xpm

F 251,237,188

C 122,216,250 lalala

1111111111111111111111111111111111111
1011000000000000000000000000000000001
1001000000000000000000000000000000001
1001100000000000000000000000000000001
1000000000010000000000000000000000001
1111100000010000000W00000000000000001
1011000000000000000000000000000000001
1111111111111111111111111111111111111
